+---+---+---+---+---+
|(A)| D           F |
+   +   +   +---+---+
| |     |     E     |
+   +   +---+---+   +
|   |   |           |
+   +   +   +---+   +
| B         |       |
+---+---+---+   +---+
| C               G |
+---+---+---+---+---+